1111111111111111111111111111111111111111
13000000P00000100000000000000000C0002001
1111111111111010101101111101111011011111
1000000000000010100000000000000000000001
100000000101100000C000010100C00001010001
1011110001011111110111010111111101011101
1000010001000000010111010100000101010001
1111011111111111010111010111111101010111
100000C000000011010000010000000001010001
1011111111111011110111110111111111111101
1010000000000010000100000100000000000001
121011111111101111110111111111C111011111
1000100000001010000000000020010001000001
1111111111101010111111111111010111111101
1000000000100010100000000000010100000001
1011111111101111110111111111010111111101
1000000000000000000100000000010003000001
1011111011111111110111111111111011111011
1000001000000030010000000C00000000000011
1111101101110111011111111111011111111011
10000000000C00000000000000000000000000E1
1111111111111111111111111111111111111111