11111111111111111
10000000000000001
1000C000030000001
100111000000000E1
10000000000000001
1P00000000C000001
11111111111111111