11111111111111111
11111111111111111
11000000000000011
11000000000000011
11000000000000011
11000000000000011
11000000000020011
11P0000C002000311
11000001000020011
11000000000000011
11000000000000011
11000000000000011
11000000000000011
11000000000000E11
11111111111111111
11111111111111111