11111111111111111
10000000000000001
1E000000000000001
11000030000000001
100000000000C0001
10000000000010001
10000000000000001
1000C000000000001
10001000000000001
10000000000000001
100000000000000C1
10000000030000011
10000000000000001
1C000000000000001
11000000000000001
10000000000000001
1P000000000C00001
11111111111111111