11111
1P00E1
10101
1C001
11111